2
5 6
######
     #
# ##  
#    #
######
11 61
#############################################################
#         #           #   #   #   #       #   #   # #     # #
##### ### # ######### # # # # # # # # ### # ### # # # ### # #
      # # # #         # #   #   # # # # # #     # #     # # #
# # ### # # # ### ##### ######### # # # # ##### # ##### # # #
# #   #   # #   # #           #   # # # #     # #       #   #
# ##### ### ### # ##### ##### # ### # # ##### # ######### ###
# # #         # #     #     # #     # #       #         # #  
# # # ####### ##### # ##### # ####### # ######### ##### # # #
#   #       # #     #       #         #           #     #   #
#############################################################
